i3                                               i0
i                                                i0
i                                                i0
i                                                i0
i                                                i0
i                         a            W         i0
i                         a            W         i0
i                         a 5        B W         i0
i1           iiiiiiiiiiiiiiiiiiiiiiiiiiiiiiiiiiiii0
iiiiiiiiiiiiiiiiiiiiiiiiiiiiiiiiiiiiiiiiiiiiiiiiii0
iiiiiiiiiiiiiiiiiiiiiiiiiiiiiiiiiiiiiiiiiiiiiiiiii0
iiiiiiiiiiiiiiiiiiiiiiiiiiiiiiiiiiiiiiiiiiiiiiiiii0
iiiiiiiiiiiiiiiiiiiiiiiiiiiiiiiiiiiiiiiiiiiiiiiiii0
i                             2                3  0